8 8
########
......##
$..#..##
##.#####
##.#####
##.#####
##.....@
########