18 18
##################
#####@...........#
##..........####.#
##.#.####.#.####.#
##.#.####.#.####.#
##.#.####.#.####.#
##.#.####.#.####.#
##........#.####.#
####.######.####.#
####.######.####.#
####.######.####.#
####.######.####.#
####.######.####.#
####.######.####.#
####.######$####.#
####.###########.#
####.............#
##################