6 6
#$####
#..###
##.###
######
##..##
###.@#